Performance test 16x16 50 cats
16 16
2 0 1 0 0 0 0 0 0 0 0 0 0 0 0 0
1 1 1 0 0 0 0 0 0 0 0 0 0 0 0 0
0 0 0 0 0 0 0 0 0 0 0 0 0 0 0 0
0 0 0 0 0 0 0 0 0 0 0 0 0 0 0 0
0 0 0 0 0 0 0 0 0 0 0 0 0 0 0 0
4 4 4 4 4 4 4 4 4 4 0 4 4 4 4 4
4 4 4 4 4 0 4 4 4 4 4 4 4 4 4 4
0 0 0 0 0 0 0 0 0 0 0 4 0 4 0 0
0 0 0 0 0 0 0 0 4 0 0 0 0 0 4 0
0 0 0 0 0 0 0 0 0 0 0 4 4 4 0 0
0 0 0 0 0 0 0 0 0 4 0 0 4 0 0 0
0 0 0 0 4 0 0 0 0 0 0 0 0 0 0 0
0 0 0 0 0 0 0 0 4 0 0 0 4 0 0 0
0 0 0 0 4 4 0 0 0 0 0 0 4 0 0 0
0 0 0 0 0 0 0 0 0 4 0 0 0 4 0 0
0 0 0 0 0 0 0 0 0 0 0 4 0 0 4 4
